WWWWWWWWWWWWWW
W000p00000000W	    
W0000p0000000W
W00300p000300W
HD1000000pS0000HD0
W0030000p0300W
W00000000000SW
W000000000000W
WWWWWWWWWWWWWW