WWWWWWWWWWWWWW
W000000033333W	    
W000000000333W
W000000000033W
W000000000D00HS0
W000000000033W
W000000000333W
W000000033333W
WWWWWWVD10WWWWWW