WWWWWWWWWWWWWW
W0p000000p000W	    
W06660Q006660W
W060000000060W
HL1060666666p60W
W060p00000060W
W066600006660W
W000000000000W
WWWWWWVD10WWWWWW