WWWWWWWWWWWWWW
W0P00p0000000W	    
W000000300000W
W0B0003030000W
W000000A03000HD0
W000B03030000W
W000000300000W
W00000000P000W
WWWWWWWWWWWWWW