WWWWWWVL00WWWWWW
W666660066666W	    
W600060000606W
W606P606606K6W
W006060060600W
W6P6060060606W
W606000060006W
W666660066666W
WWWWWWVD10WWWWWW