WWWWWWWWWWWWWW
W000000000000W	    
W033333333330W
W030010020030W
HD103010T002030W
W030000000030W
W033330033330W
W000000000000W
WWWWWWWWWWWWWW