WWWWWWVD00WWWWWW
W000000000000W
W010010020020W
W000000000000W
HD1010010020020HD0
W000004400000W
W010414424020W
W000444444000W
WWWWWWWWWWWWWW
f