WWWWWWWWWWWWWW
WC55555555555W
W555555555555W
W555555555555W
W555555555555HD0
W555555555555W
W555555555555W
W555555555555W
WWWWWWWWWWWWWW