WWWWWWWWWWWWWW
W000000000000W
W00S000S00S00W
W003300003300W
HD1003300003300W
W0033000S3300W
W000S000000Q0W
W000000000000W
WWWWWWWWWWWWWW
f