WWWWWWWWWWWWWW
W000000000000W
W00300p0003B0W
W00000B000000W
HD1000000000K00W
W00000000B000W
W0030000003B0W
W000B00000000W
WWWWWWWWWWWWWW
f