WWWWWWWWWWWWWW
W000000000000W
W0G0000000000W
W0K0G00000000W
W000000000000HD0
W000000000000W
W0G0000000000W
W000000000000W
WWWWWWWWWWWWWW