WWWWWWWWWWWWWW
W000000000000W	    
W000000000000W
W000000000000W
HS1000003000000HD0
W000000000000W
W000000000000W
W000000000000W
WWWWWWVD10WWWWWW