WWWWWWVD00WWWWW
W00000000S000W
W000000000000W
W000S003300S0W
W000000330000W
W000000330000W
W000000000000W
W000000000000W
WWWWWWWVD10WWWW
f