WWWWWWVL00WWWWWW
W000000000000W	    
W000B00000B00W
W0B0003300000W
W000B03300000HD0
W000003300000W
W000000000000W
W000000000000W
WWWWWWWWWWWWWW