WWWWWWWWWWWWWW
W000000000000W
WS00S00000000W
W003000000300W
HDS0S0000000000HD0
W0S3000000300W
W000000000000W
W000000000000W
WWWWWWVD10WWWWWW
t