WWWWWWVL00WWWWWW
W00000000SB00W	    
W0303033P3030W
W000S00000000W
HD1030303303030W
W000000000S00W
W030303303030W
W00000000B000W
WWWWWWWWWWWWWW