WWWWWWVD00WWWWWW
W0G000000000GW	    
W033000000330W
W000000000000W
HD1000003300000HL0
W000000000000W
W03300000G330W
W00000000000GW
WWWWWWWWWWWWWW